132
8
10 10 10 10 10 10 10 10 10 10 10 10 10 10 10 10 10 10 10 10 10 10 10 10 10 10 10 10 10 10 10 10 10 10 10 10 10 10 10 10 10 10 10 10 10 10 10 10 10 10 10 10 10 10 10 10 10 10 10 10 10 10 10 10 10 10 10 10 10 10 10 10 10 10 10 10 10 10 10 10 10 10 12 14 10 10 10 10 10 10 10 10 10 10 10 10 10 10 10 10 10 10 10 10 10 10 10 10 10 10 10 10 10 10 10 49 10 10 10 10 10 10 10 10 10 12 13 13 49 13 13 13 
10 10 10 10 10 10 10 10 10 10 10 10 10 10 10 10 10 10 10 10 10 10 10 10 10 10 10 10 10 10 10 10 10 10 10 10 10 10 10 10 10 10 10 10 10 10 10 10 10 10 10 10 10 10 10 10 10 10 10 10 10 10 10 10 10 10 10 10 10 10 10 10 10 10 10 10 10 10 10 10 10 10 12 14 10 10 10 10 10 10 10 10 10 10 10 10 10 10 10 10 10 10 10 10 10 10 10 10 10 10 10 10 10 10 10 49 10 10 10 10 10 10 10 10 10 12 13 13 49 13 13 13 
10 10 10 10 10 10 10 10 10 10 10 10 10 10 10 10 10 10 10 10 10 10 10 10 10 10 10 10 42 01 01 02 10 10 10 10 10 10 10 10 10 10 10 10 10 10 10 10 10 10 10 10 10 10 10 10 10 10 10 10 10 10 10 10 10 10 42 43 44 10 10 10 10 10 10 10 10 10 10 10 10 10 24 26 10 10 10 10 10 10 10 10 10 10 10 10 10 10 10 10 10 10 10 10 10 10 10 10 10 10 10 10 10 10 10 40 10 10 10 10 10 10 10 10 10 12 13 49 49 13 13 13 
10 10 10 10 10 10 10 10 10 10 10 10 10 10 10 10 10 10 10 10 10 10 10 10 10 10 10 10 12 13 13 13 02 10 10 10 10 10 10 10 10 10 10 10 10 10 10 10 10 10 10 10 10 10 10 10 10 10 10 10 10 10 42 43 44 10 10 10 10 10 10 10 10 10 10 10 10 10 10 10 10 10 10 10 10 10 10 10 10 10 10 10 10 10 10 10 10 10 10 10 10 10 10 10 10 10 10 10 10 10 10 10 10 10 10 10 10 10 10 10 10 10 10 10 10 12 49 49 49 49 13 13 
10 10 10 10 10 10 10 10 10 10 10 10 10 10 10 10 10 10 10 10 10 10 10 10 10 10 10 10 12 13 13 13 13 01 02 10 10 10 10 10 10 10 10 10 10 10 10 10 10 10 10 10 10 10 10 10 10 10 10 10 10 10 10 10 10 10 10 10 10 10 42 43 43 43 44 10 10 10 42 44 10 10 10 10 10 10 10 10 10 10 10 10 10 10 10 10 10 10 10 10 10 10 10 10 10 10 10 10 10 10 10 36 38 10 10 10 10 10 10 10 10 10 10 10 10 12 49 49 49 49 49 13 
10 10 10 10 10 10 10 10 10 10 10 10 10 10 10 10 42 01 01 01 01 01 01 01 01 01 01 01 01 13 13 13 13 13 13 02 10 10 10 10 10 10 10 10 10 10 10 10 10 10 10 42 01 01 01 01 01 01 02 10 10 10 10 10 10 10 10 10 10 10 10 10 10 10 10 10 10 10 12 10 10 10 10 42 43 44 10 10 36 37 37 37 37 37 38 10 10 10 10 10 10 10 10 10 10 42 43 44 10 10 10 48 10 10 10 10 42 01 01 01 01 01 01 01 01 02 49 49 49 49 49 13 
10 10 10 10 10 10 10 10 10 10 10 10 10 10 10 42 13 13 13 13 13 13 13 13 13 13 13 13 13 13 13 13 13 13 13 13 01 01 01 01 01 01 01 01 01 01 01 01 01 01 01 13 13 13 13 13 13 13 14 10 10 10 10 10 10 10 00 10 10 10 10 10 10 10 10 10 42 43 44 10 10 10 10 10 10 10 10 10 48 49 49 49 49 49 49 37 37 37 37 37 37 38 10 10 10 10 10 10 10 36 37 59 10 10 10 10 12 13 13 13 13 13 13 13 13 13 13 49 49 49 49 13
10 10 10 10 10 10 10 12 13 13 13 13 13 13 13 13 13 13 13 13 13 13 13 13 13 13 13 13 13 13 13 13 13 13 13 13 13 13 13 13 13 13 13 13 13 13 13 13 13 13 13 13 13 13 13 13 13 13 14 10 10 10 10 10 10 10 10 10 10 10 10 10 10 10 10 10 06 07 08 10 10 10 10 10 10 10 10 10 48 49 49 49 49 49 49 49 49 49 49 49 49 49 37 37 37 37 37 37 37 37 10 59 10 10 10 10 12 13 13 13 13 13 13 13 13 13 13 13 13 13 13 13