132
8
10 10 10 10 10 10 10 10 10 10 10 10 10 10 10 10 10 10 10 10 10 10 10 10 10 10 10 10 10 10 10 10 10 10 10 10 10 10 10 10 10 10 10 10 10 10 36 17 26 10 10 10 10 10 10 10 10 10 10 10 10 10 10 10 10 10 10 10 10 10 10 10 10 10 10 10 10 10 10 10 10 10 36 25 26 10 10 10 10 10 10 10 10 10 10 10 10 10 10 10 10 10 10 10 10 10 10 10 10 10 10 10 10 10 10 43 10 10 10 10 10 10 10 10 10 10 10 10 10 10 10 10 
10 10 10 10 10 10 10 10 10 10 10 10 10 10 10 10 10 10 10 10 10 10 10 10 10 10 10 10 10 10 10 10 10 10 10 10 10 10 10 10 10 10 10 10 10 10 10 29 26 10 10 10 10 10 10 10 10 10 10 10 10 10 10 10 10 10 10 10 10 10 10 10 10 10 10 10 10 10 10 10 10 10 10 24 38 10 10 10 10 10 10 10 10 10 10 10 10 10 10 10 10 10 10 10 10 10 10 10 10 10 10 10 10 10 10 43 10 10 10 10 10 10 10 10 10 10 10 10 10 10 10 10 
10 10 10 10 10 10 10 10 10 10 10 10 10 10 10 10 10 10 10 10 10 10 10 10 10 10 10 10 12 14 10 10 10 10 10 10 10 10 12 14 10 10 10 10 10 10 10 29 26 10 10 10 10 10 10 10 10 10 10 10 10 10 10 10 10 10 10 54 55 56 10 10 10 10 10 10 10 10 10 10 10 10 12 26 10 10 10 10 10 10 10 10 10 10 10 10 10 10 54 56 10 10 10 10 10 10 10 10 10 10 10 10 10 10 10 16 10 10 10 10 10 10 10 10 10 10 10 10 10 10 54 55 
10 10 10 10 10 10 10 10 10 10 10 10 10 10 10 10 10 10 10 10 10 10 10 10 10 10 10 10 24 39 14 10 10 10 10 10 12 13 13 39 14 10 10 10 10 10 10 36 38 10 10 10 10 10 10 10 10 10 10 10 10 54 55 55 56 10 10 10 10 10 10 10 10 10 10 10 10 10 10 10 10 10 36 38 10 10 10 10 10 10 10 10 10 10 10 10 12 13 13 14 10 10 10 10 10 10 10 10 10 10 10 10 10 10 10 10 10 10 10 10 54 55 56 10 10 48 50 10 10 54 55 56   
10 10 10 10 10 10 10 10 10 10 10 10 10 10 10 10 12 14 10 10 10 10 10 10 10 10 10 12 13 25 14 10 10 10 10 10 10 10 10 10 10 10 10 10 10 10 10 10 10 10 10 10 10 10 10 10 10 12 14 10 10 10 10 10 10 10 10 10 10 10 10 54 55 55 56 10 10 10 12 14 10 10 10 10 10 10 54 56 10 10 10 10 10 10 10 10 10 10 10 10 10 10 10 10 10 48 50 10 10 10 10 10 10 10 10 10 10 10 48 50 10 10 10 10 10 60 62 10 10 10 10 10  
10 10 10 10 10 10 10 10 10 10 10 10 10 10 10 12 13 26 10 10 10 10 10 10 10 10 10 12 13 13 39 13 13 13 14 10 10 10 10 10 10 10 12 14 10 10 10 10 10 10 10 10 10 10 10 10 12 41 26 10 10 10 10 10 10 10 10 10 10 10 10 10 10 10 10 10 12 13 41 38 10 10 10 10 10 10 10 10 54 55 56 10 10 10 10 10 10 10 10 10 10 10 10 10 48 77 62 10 10 54 55 55 56 10 10 10 10 10 60 62 10 10 10 10 48 77 62 10 10 10 10 10   
10 10 10 10 10 10 10 10 10 10 10 10 10 10 10 24 25 26 10 10 12 13 13 13 13 13 13 13 41 25 25 25 25 13 26 10 10 10 10 10 10 10 10 10 10 10 10 10 10 10 10 12 13 13 13 13 41 25 26 10 10 10 10 10 10 10 10 10 10 10 10 10 10 10 10 10 36 37 38 10 10 54 55 55 56 10 10 10 48 49 49 49 49 49 50 10 10 10 10 10 10 10 10 10 60 49 62 10 10 10 10 10 10 10 10 10 10 48 77 62 10 10 10 48 77 61 75 49 49 50 10 10 
10 10 10 10 10 10 10 12 13 13 13 13 13 13 13 41 25 13 13 13 13 13 13 13 13 13 13 13 13 13 13 13 13 13 26 10 10 10 10 10 10 10 10 10 10 12 13 13 13 13 13 13 13 25 25 25 25 25 26 10 10 10 10 10 10 10 10 10 10 10 10 10 10 10 10 10 10 10 10 10 10 10 10 10 10 10 10 10 60 49 49 61 61 75 62 10 10 10 10 10 10 10 48 49 77 61 75 49 50 10 10 10 10 10 48 49 77 61 61 75 50 10 10 60 61 61 61 61 61 62 10 10

