156
10
10 10 10 10 10 10 10 10 10 10 10 10 10 10 10 10 10 10 10 10 10 10 10 10 10 10 10 10 10 10 10 10 10 10 10 10 10 10 10 10 10 10 10 10 10 10 10 10 10 10 10 10 10 10 10 10 10 10 10 10 10 10 10 10 10 10 10 10 10 10 10 10 10 10 10 10 10 10 10 10 10 10 10 10 10 10 10 10 10 10 10 10 42 23 31 31 31 31 31 31 31 43 43 44 10 10 10 10 10 10 10 10 10 10 10 10 10 10 42 31 31 31 31 31 31 31 32 10 10 10 10 10 10 10 10 10 10 10 10 10 10 10 10 10 10 10 10 10 10 10 10 10 10 10 10 10
10 10 10 10 10 10 10 10 10 10 10 10 10 10 10 10 10 10 10 10 10 10 10 10 10 10 10 10 10 10 10 10 10 10 10 10 10 10 10 10 10 10 10 10 10 10 10 10 10 10 10 10 10 10 10 10 10 10 10 10 10 10 10 10 10 10 10 10 10 10 10 10 10 10 10 10 10 10 10 10 10 10 10 10 10 10 10 10 10 10 10 10 10 42 43 43 31 31 31 31 31 31 32 10 10 10 10 10 10 10 10 10 10 10 10 10 10 10 42 43 43 23 31 31 31 31 32 10 10 10 10 10 10 10 10 10 10 10 10 10 10 10 10 10 10 10 10 10 10 10 10 10 10 10 10 10
10 10 10 10 10 10 10 10 10 10 10 10 10 10 10 10 10 10 10 10 10 10 10 10 10 10 10 12 14 10 10 10 10 10 10 10 10 10 10 10 10 10 10 10 10 10 10 12 13 13 14 10 10 10 10 10 10 10 10 10 10 10 10 10 10 10 10 10 10 10 10 10 10 10 10 10 10 10 10 10 10 10 10 10 10 10 10 10 10 10 10 10 10 42 43 43 43 43 43 23 31 31 32 10 10 10 10 10 10 10 10 10 10 10 10 10 10 10 10 10 10 42 23 31 31 31 44 10 10 10 10 10 10 10 10 10 10 10 10 10 10 10 10 10 18 19 20 10 10 10 10 10 10 10 10 10
10 10 10 10 10 10 10 10 10 10 10 10 10 10 10 10 10 10 10 10 12 13 13 14 10 12 13 41 26 10 10 10 10 10 10 10 10 10 10 10 10 10 10 10 12 14 10 10 10 10 10 10 10 10 10 10 10 10 10 10 10 10 12 14 10 10 10 10 10 10 10 10 10 10 10 10 10 10 10 18 20 10 10 10 10 10 10 10 10 10 10 10 10 10 10 10 10 10 10 42 43 43 44 10 10 10 10 10 10 10 10 10 10 10 10 10 10 10 10 10 10 10 42 43 43 43 44 10 10 10 10 10 10 10 10 10 10 10 10 18 19 19 20 10 10 10 10 10 10 10 10 10 10 10 10 10
10 10 10 10 10 10 10 10 10 10 10 10 10 10 10 10 10 10 10 10 36 37 37 38 10 10 10 10 10 10 12 14 10 10 10 10 10 10 10 10 10 10 10 12 41 26 10 10 10 10 10 12 13 14 10 10 10 10 10 10 10 12 41 27 10 10 10 10 10 10 10 10 10 10 10 10 18 19 19 47 32 10 10 10 10 10 10 10 10 10 10 10 10 10 10 10 10 10 10 10 10 10 10 10 10 10 10 10 10 10 10 10 18 20 10 10 10 10 18 19 20 10 10 10 10 10 10 10 10 10 10 10 10 10 10 10 10 10 10 30 31 31 32 10 10 10 10 10 10 10 10 10 10 10 10 10
10 10 10 10 10 10 10 10 10 10 10 10 10 10 10 10 10 12 14 10 10 10 10 10 10 10 10 10 10 10 24 26 10 10 10 10 10 10 10 10 10 10 10 24 25 26 10 10 10 10 10 10 10 10 10 10 10 10 10 10 10 24 25 39 40 10 10 10 10 10 10 10 10 18 20 10 10 10 10 10 10 10 18 20 10 10 10 10 10 10 10 10 10 18 19 19 19 19 20 10 10 10 10 10 10 18 19 19 20 10 18 19 47 32 10 18 19 19 18 31 32 10 10 10 10 10 10 10 10 10 10 10 10 10 10 10 10 10 18 47 31 31 32 10 10 10 10 10 10 10 10 10 10 10 10 10  
10 10 10 10 10 10 10 10 10 10 10 10 10 10 12 13 13 41 26 10 10 10 10 10 10 10 10 10 10 10 24 39 13 14 10 10 10 10 10 10 10 10 12 41 25 26 10 10 10 10 10 10 10 10 10 10 10 10 10 10 12 40 25 25 26 10 10 10 10 10 18 19 19 47 32 10 10 10 10 10 10 10 30 45 46 19 19 20 10 10 10 10 10 30 31 31 31 31 45 46 19 19 19 20 10 42 43 43 44 10 10 10 10 10 10 30 31 31 31 31 20 10 10 10 10 10 10 10 10 10 10 10 10 10 10 18 20 10 18 18 31 31 45 46 46 46 20 10 10 10 10 10 10 10 10 10
10 10 10 10 10 10 10 10 10 10 10 10 10 10 24 25 25 25 26 10 10 10 10 10 10 10 10 10 10 10 12 13 25 39 40 40 40 13 13 13 13 13 13 25 25 39 40 13 13 13 14 10 10 10 10 10 10 10 10 10 24 25 25 25 39 40 13 13 14 10 10 10 10 10 10 10 10 10 10 10 10 10 18 31 31 31 31 19 19 19 19 46 19 47 31 31 31 31 31 31 31 19 19 20 10 10 10 10 10 10 10 10 10 10 10 18 19 31 31 31 45 46 19 19 19 19 20 10 10 10 10 10 18 19 19 47 32 10 18 31 31 31 31 31 31 19 19 19 20 10 10 10 10 10 10 10
10 10 10 10 10 10 10 10 12 13 13 13 13 13 13 13 25 25 39 14 10 10 10 10 10 10 10 10 10 10 24 25 25 25 25 25 25 25 25 25 25 25 25 25 25 25 25 25 25 25 39 40 13 13 40 40 13 40 13 40 40 25 25 25 25 25 25 25 26 10 10 10 10 10 10 10 10 10 10 10 10 10 30 31 31 31 31 31 31 31 31 31 31 31 31 31 31 31 31 31 31 31 31 32 10 10 10 10 10 10 10 10 10 10 10 30 31 31 31 31 31 31 31 31 31 19 19 19 19 19 20 10 10 10 10 10 10 10 30 31 31 31 31 31 31 31 31 31 32 10 10 10 10 10 10 10
10 10 10 10 10 10 10 10 24 25 25 25 25 25 25 25 25 25 25 26 10 10 10 10 10 10 10 10 10 10 24 25 25 25 25 25 25 25 25 25 25 25 25 25 25 25 25 25 25 25 25 25 25 25 25 25 25 25 25 25 25 25 25 25 25 25 25 25 26 10 10 10 10 10 10 10 10 10 10 10 10 10 30 31 31 31 31 31 31 31 31 31 31 31 31 31 31 31 31 31 31 31 31 32 10 10 10 10 10 10 10 10 10 10 10 30 31 31 31 31 31 31 31 31 31 31 31 31 31 31 32 10 10 10 10 10 10 10 30 31 31 31 31 31 31 31 31 31 32 10 10 10 10 10 10 10