132
8
10 10 10 10 10 10 70 10 10 10 10 10 10 10 10 10 10 10 10 10 10 10 10 10 10 10 10 10 10 10 10 10 10 10 10 10 10 10 10 10 10 10 10 10 10 10 36 17 26 10 10 10 10 10 10 10 10 10 10 10 10 10 10 10 10 10 10 10 10 10 10 10 10 10 10 10 10 10 10 10 10 10 36 25 26 10 10 10 10 10 10 10 10 10 10 10 10 10 10 10 10 10 10 10 10 10 10 10 10 10 10 10 10 10 24 26 10 10 10 10 10 10 10 10 10 10 10 10 10 10 10 10 
10 10 10 10 10 10 70 10 10 10 10 10 10 10 10 10 10 10 10 10 10 10 10 10 10 10 10 10 10 10 10 10 10 10 10 10 10 10 10 10 10 10 10 10 10 10 10 29 26 10 10 10 10 10 10 10 10 10 10 10 10 10 10 10 10 10 10 10 10 10 10 10 10 10 10 10 10 10 10 10 10 10 10 24 38 10 10 10 10 10 10 10 10 10 10 10 10 10 10 10 10 10 10 10 10 10 10 10 10 10 10 10 10 10 24 26 10 10 10 10 10 10 10 10 10 10 10 10 10 10 10 10 
10 10 10 10 10 10 70 10 10 10 10 10 10 10 10 10 10 10 10 10 10 10 10 10 10 10 10 10 12 14 10 10 10 10 10 10 10 10 12 14 10 10 10 10 10 10 10 29 26 10 10 10 10 10 10 10 10 10 10 10 10 10 10 10 10 10 10 54 55 56 10 10 10 10 10 10 10 10 10 10 10 10 10 36 10 10 10 10 10 10 10 10 10 10 10 10 10 10 10 10 10 10 10 10 10 10 10 10 10 10 10 10 10 10 36 38 10 10 10 10 10 10 10 10 10 10 10 10 10 10 54 56 
10 10 10 10 10 10 70 10 10 10 10 10 10 10 10 10 10 10 10 10 10 10 10 10 10 10 10 10 24 39 14 10 10 10 10 10 12 13 13 39 14 10 10 10 10 10 10 36 38 10 10 10 10 10 10 10 10 10 10 10 10 54 55 55 56 10 10 10 10 10 10 10 10 10 10 10 10 10 10 10 10 10 54 56 10 10 10 10 10 10 10 10 10 10 10 10 10 10 10 10 10 54 56 10 10 10 10 10 10 10 10 10 10 10 10 10 10 10 10 10 54 55 56 10 10 12 14 10 10 10 10 10   
10 10 10 10 10 10 70 10 10 10 10 10 10 10 10 10 12 14 10 10 10 10 10 10 10 10 10 12 13 25 14 10 10 10 10 10 36 37 37 37 38 10 10 10 10 10 10 10 10 10 10 10 10 10 10 10 10 12 14 10 10 10 10 10 10 10 10 10 10 10 10 54 55 55 56 10 10 10 12 14 10 10 10 10 10 10 54 56 10 10 10 10 10 10 10 10 12 13 13 14 10 10 10 10 10 12 14 10 10 10 10 10 10 10 10 10 10 10 12 14 10 10 10 10 10 24 26 10 10 54 55 56  
10 10 10 10 10 10 70 10 10 10 10 10 10 10 10 12 13 26 10 10 10 10 10 10 10 10 10 12 13 13 39 13 13 13 14 10 10 10 10 10 10 10 12 14 10 10 10 10 10 10 10 10 10 10 10 10 12 41 26 10 10 10 10 10 10 10 10 10 10 10 10 10 10 10 10 10 12 13 41 38 10 10 10 10 10 10 10 10 10 10 10 10 10 10 10 10 24 25 25 26 10 10 10 10 12 41 26 10 10 54 55 55 56 10 10 10 10 10 24 26 10 10 10 10 12 41 26 10 10 10 10 10   
10 10 10 10 10 10 70 10 10 10 10 10 10 10 10 24 25 26 10 10 12 13 13 13 13 13 13 13 41 25 25 25 25 13 26 10 10 10 10 10 10 10 24 26 10 10 10 10 10 10 10 12 13 13 13 13 41 25 26 10 10 10 10 10 10 10 10 10 10 10 10 10 10 10 10 10 36 37 38 10 10 54 55 55 56 10 10 10 12 13 13 13 13 13 14 10 24 25 25 26 10 10 10 10 24 13 26 10 10 10 10 10 10 10 10 10 10 12 41 26 10 10 10 12 41 25 39 13 13 14 10 10 
10 10 10 10 10 10 70 12 13 13 13 13 13 13 13 41 25 13 13 13 13 13 13 13 13 13 13 13 13 13 13 13 13 13 26 10 10 10 10 10 10 10 24 26 10 12 13 13 13 13 13 13 13 25 25 25 25 25 26 10 10 10 10 10 10 10 10 10 10 10 10 10 10 10 10 10 10 10 10 10 10 10 10 10 10 10 10 10 24 13 13 25 25 39 26 10 24 25 12 13 14 10 12 13 41 25 39 13 14 10 10 10 10 10 12 13 13 25 25 39 14 10 10 24 25 25 25 25 25 26 10 10

