132
8
32 32 32 61 61 61 62 0 0 0 0 0 0 0 0 0 0 0 0 0 0 0 0 0 0 0 0 0 0 0 0 0 0 0 0 0 0 0 0 0 0 0 0 0 0 0 0 0 0 0 0 0 0 0 0 0 0 0 0 0 0 0 0 0 0 0 0 0 0 0 0 0 0 0 0 0 0 0 0 0 0 0 36 0 0 0 0 0 0 0 0 0 0 0 0 0 0 0 0 0 0 0 0 0 0 0 0 0 0 0 0 0 0 0 0 36 0 0 0 0 0 0 0 0 0 37 37 37 31 30 30 31 
32 32 32 61 61 61 62 0 0 0 0 0 0 0 0 0 0 0 0 0 0 0 0 0 0 0 0 0 0 0 0 0 0 0 0 0 0 0 0 0 0 0 0 0 0 0 0 0 0 0 0 0 0 0 0 0 0 0 0 0 0 0 0 0 0 0 0 0 0 0 0 0 0 0 0 0 0 0 0 0 0 0 33 0 0 0 0 0 0 0 0 0 0 0 0 0 0 0 0 0 0 0 0 0 0 0 0 0 0 0 0 0 0 0 0 33 0 0 0 0 0 0 0 0 0 37 37 37 32 31 32 32 
32 32 32 61 61 61 62 0 0 0 0 0 0 0 0 0 0 0 0 0 0 0 0 0 0 0 0 0 12 13 13 14 0 0 0 0 0 0 0 0 0 0 0 0 0 0 0 0 0 0 0 0 0 0 0 0 0 0 0 0 0 0 0 0 0 0 3 33 4 0 0 0 0 0 0 0 0 0 0 0 0 0 35 0 0 0 0 0 0 0 0 0 0 0 0 0 0 0 0 0 0 0 0 0 0 0 0 0 0 0 0 0 0 0 0 35 0 0 0 0 0 0 0 0 0 37 37 37 32 30 32 30 
32 32 12 13 14 61 62 0 0 0 0 0 0 0 0 0 0 0 0 0 0 0 0 0 0 0 0 0 24 31 32 32 14 0 0 0 0 0 0 0 0 0 0 0 0 0 0 0 0 0 0 0 0 0 0 0 0 0 0 0 0 0 55 56 57 0 0 35 0 0 0 0 0 0 0 0 0 0 0 0 0 0 0 0 0 0 0 0 0 0 0 0 0 0 0 0 0 0 0 0 0 0 0 0 0 0 35 0 0 0 0 0 0 0 0 0 0 0 0 0 0 0 0 0 0 37 37 37 31 30 32 32 
32 32 32 61 61 61 62 0 0 0 0 0 0 0 0 0 0 0 0 0 0 0 0 0 0 0 0 0 24 30 32 32 12 13 14 0 0 0 0 0 0 0 0 0 0 0 0 0 0 0 0 0 0 0 0 0 0 0 0 0 0 0 0 35 0 0 0 35 0 0 3 33 34 33 4 0 0 0 38 0 0 0 0 0 0 0 0 0 0 0 0 0 0 0 0 0 0 0 0 0 0 0 0 0 0 0 35 0 0 0 0 35 0 0 0 0 0 0 0 0 0 0 0 0 0 36 36 36 31 32 32 32 
32 32 32 61 61 61 62 0 0 0 0 0 0 0 0 0 12 13 13 13 13 13 13 13 13 33 34 33 31 32 30 13 13 13 13 13 0 0 0 0 0 0 0 0 0 0 0 0 0 0 0 12 13 13 13 14 33 34 33 4 0 0 0 35 0 0 0 35 0 0 0 35 0 35 0 0 0 0 37 0 0 0 0 0 0 0 0 0 3 33 34 33 34 33 4 0 0 0 0 0 0 0 38 0 0 3 33 4 0 0 0 35 0 0 0 0 3 33 34 33 34 32 32 31 32 30 32 32 32 32 31 32 
13 14 32 61 61 61 62 0 0 0 0 0 0 0 0 12 31 30 32 35 0 35 0 35 0 35 0 35 30 31 32 30 32 31 32 32 12 13 13 13 13 13 13 13 13 13 13 14 31 31 31 32 31 30 30 31 35 0 35 0 0 0 0 35 0 0 0 35 0 0 0 35 0 35 0 0 0 3 33 4 0 0 38 0 0 0 0 0 0 35 0 35 0 30 32 31 30 32 32 30 31 32 36 0 0 0 35 0 0 0 3 33 4 0 0 0 0 35 0 32 32 31 30 31 32 30 31 32 30 31 30 32 
32 32 32 61 61 61 12 13 13 13 13 13 13 39 31 30 32 30 31 35 0 35 0 35 0 35 0 35 32 31 32 30 30 32 32 31 31 30 30 32 30 32 31 32 30 32 31 30 31 32 31 32 30 31 31 32 32 0 35 0 0 0 0 35 0 0 0 35 0 0 0 35 0 35 0 0 0 0 35 0 0 0 33 0 0 0 0 0 0 35 0 30 31 32 32 31 32 32 30 32 30 32 32 32 32 32 35 0 0 0 0 35 0 0 0 0 0 32 30 32 31 31 32 32 31 32 30 32 32 30 32 31