132
8
55 55 55 55 55 55 14 70 70 70 70 70 70 70 70 70 70 70 70 70 70 70 70 70 70 70 70 70 70 70 70 70 70 70 70 70 70 70 70 70 70 70 70 70 70 70 70 70 70 70 70 70 70 70 70 70 70 70 70 70 70 70 70 70 70 70 70 70 70 70 70 70 70 70 70 70 70 70 70 70 70 70 12 14 70 70 70 70 70 70 70 70 70 70 70 70 70 70 70 70 70 70 70 70 70 70 70 70 70 70 70 70 70 70 70 49 70 70 70 70 70 70 70 70 70 12 13 13 49 13 13 13 
55 55 55 55 55 55 14 70 70 70 70 70 70 70 70 70 70 70 70 70 70 70 70 70 70 70 70 70 70 70 70 70 70 70 70 70 70 70 70 70 70 70 70 70 70 70 70 70 70 70 70 70 70 70 70 70 70 70 70 70 70 70 70 70 70 70 70 70 70 70 70 70 70 70 70 70 70 70 70 70 70 70 12 14 70 70 70 70 70 70 70 70 70 70 70 70 70 70 70 70 70 70 70 70 70 70 70 70 70 70 70 70 70 70 70 49 70 70 70 70 70 70 70 70 70 12 13 13 49 13 13 13 
55 55 55 55 55 55 14 70 70 70 70 70 70 70 70 70 70 70 70 70 70 70 70 70 70 70 70 70 42 01 01 02 70 70 70 70 70 70 70 70 70 70 70 70 70 70 70 70 70 70 70 70 70 70 70 70 70 70 70 70 70 70 70 70 70 70 42 43 44 70 70 70 70 70 70 70 70 70 70 70 70 70 24 26 70 70 70 70 70 70 70 70 70 70 70 70 70 70 70 70 70 70 70 70 70 70 70 70 70 70 70 70 70 70 70 40 70 70 70 70 70 70 70 70 70 12 13 49 49 13 13 13 
55 55 55 55 55 55 14 70 70 70 70 70 70 70 70 70 70 70 70 70 70 70 70 70 70 70 70 70 12 13 13 13 02 70 70 70 70 70 70 70 70 70 70 70 70 70 70 70 70 70 70 70 70 70 70 70 70 70 70 70 70 70 42 43 44 70 70 70 70 70 70 70 70 70 70 70 70 70 70 70 70 70 70 70 70 70 70 70 70 70 70 70 70 70 70 70 70 70 70 70 70 70 70 70 70 70 70 70 70 70 70 70 70 70 70 70 70 70 70 70 70 70 70 70 70 12 49 49 49 49 13 13 
55 55 55 55 55 55 14 70 70 70 70 70 70 70 70 70 70 70 70 70 70 70 70 70 70 70 70 70 12 13 13 13 13 01 02 70 70 70 70 70 70 70 70 70 70 70 70 70 70 70 70 70 70 70 70 70 70 70 70 70 70 70 70 70 70 70 70 70 70 70 42 43 43 43 44 70 70 70 42 44 70 70 70 70 70 70 70 70 70 70 70 70 70 70 70 70 70 70 70 70 70 70 70 70 70 70 70 70 70 70 70 36 38 70 70 70 70 70 70 70 70 70 70 70 70 12 49 49 49 49 49 13 
55 55 55 55 55 55 14 70 70 70 70 70 70 70 70 70 42 01 01 01 01 01 01 01 01 01 01 01 01 13 13 13 13 13 13 02 70 70 70 70 70 70 70 70 70 70 70 70 70 70 70 42 01 01 01 01 01 01 02 70 70 70 70 70 70 70 70 70 70 70 70 70 70 70 70 70 70 70 12 70 70 70 70 42 43 44 70 70 36 37 37 37 37 37 38 70 70 70 70 70 70 70 38 70 70 42 43 44 70 70 70 48 70 70 70 70 42 01 01 01 01 01 01 01 01 02 49 49 49 49 49 13 
55 55 55 55 55 55 14 70 70 70 70 70 70 70 70 42 13 13 13 13 13 13 13 13 13 13 13 13 13 13 13 13 13 13 13 13 01 01 01 01 01 01 01 01 01 01 01 01 01 01 01 13 13 13 13 13 13 13 14 70 70 70 70 70 70 70 00 70 70 70 70 70 70 70 70 70 42 43 44 70 70 70 70 70 70 70 70 70 48 49 49 49 49 49 49 37 37 37 37 37 37 38 70 70 70 35 70 70 70 36 37 59 70 70 70 70 12 13 13 13 13 13 13 13 13 13 13 49 49 49 49 13
55 55 55 55 55 55 42 01 01 01 01 01 01 01 01 01 02 13 13 13 13 13 13 13 13 13 13 13 13 13 13 13 13 13 13 13 13 13 13 13 13 13 13 13 13 13 13 13 13 13 13 13 13 13 13 13 13 13 14 70 70 70 70 70 70 70 70 70 70 70 70 70 70 70 70 70 06 07 08 70 70 70 70 70 70 70 70 70 48 49 49 49 49 49 49 49 49 49 49 49 49 49 37 37 37 37 37 37 37 37 70 59 70 70 70 70 12 13 13 13 13 13 13 13 13 13 13 13 13 13 13 13